XXXXXXXXXXXXXXXXXXXXXXXXXXXXXXXXXXXXXXXXXXXXXXXXXXXXXXXXXXXXXXXXXXXXXXXXXXXXXXXXXXXXXXXXXXXXXXXXXXXX
XXXXXXXXXXXXXXXXXXXXXXXXXXXXXXXXXXXXXXXXXXXXXXXXXXXXXXXXXXXXXXXXXXXXXXXXXXXXXXXXXXXXXXXXXXXXXXXXXXXX
XXXX          XX         XXXXX    X           XXXXXXXX           X    XXXXX         XX          XXXX
XXXX XXXXXXXXXXXXXXXXXXX XXXXX XXXXXXX XXXXXX XXXXXXXX XXXXXX XXXXXXX XXXXX XXXXXXXXXXXXXXXXXXX XXXX
XXXX XXXXXXXXXXXXXXXXXXX XXXXX XXXXXXX XXXXXX    XX    XXXXXX XXXXXXX XXXXX XXXXXXXXXXXXXXXXXXX XXXX
XXXX XXXXXXX    X              XXXXXXX   X    XXXXXXXX    X   XXXXXXX              X    XXXXXXX XXXX
XXXX XXXXXXX XXXXXXX XXXXXXXXXXXXXXXXX XXXXXX XXXXXXXX XXXXXX XXXXXXXXXXXXXXXXX XXXXXXX XXXXXXX XXXX
XXXX XXXXXXX         XXXXXXXXXXXXXXXXX XXXXX            XXXXX XXXXXXXXXXXXXXXXX         XXXXXXX XXXX
XXXX XXXXXXX XXXXXXX XXXXXXXXXXXXXXXXX XXXXX XXXXXXXXXX XXXXX XXXXXXXXXXXXXXXXX XXXXXXX XXXXXXX XXXX
XXXX         XXXXXXX                         XXXXXXXXXX                         XXXXXXX         XXXX
XXXXXXXXXXXX XXXXXXX XXXXXXXXXXX XXXXXXXXXXX XXXXXXXXXX XXXXXXXXXXX XXXXXXXXXXX XXXXXXX XXXXXXXXXXXX
XXXX         XXX     XXXXXXXXXXX XXXXXXXXXXX XXXXXXXXXX XXXXXXXXXXX XXXXXXXXXXX     XXX         XXXX
XXXX XXXXXXXXXXX XXX          X                  XX                  X          XXX XXXXXXXXXXX XXXX
XXXX         XXX XXXXXXXXX XXXXXXX XXXXXX XXXXXXXXXXXXXXXX XXXXXX XXXXXXX XXXXXXXXX XXX         XXXX
XXXXXXXXXXXX XXX XXXXXXXXX XXXXXXX XXX XX XXXXXXXXXXXXXXXX XX XXX XXXXXXX XXXXXXXXX XXX XXXXXXXXXXXX
XXXXXXXX XXX XXX XXXXXXXXX XXXXXXX XXX XX                  XX XXX XXXXXXX XXXXXXXXX XXX XXX XXXXXXXX
XXXXXXXX XXX          X                   XXXXXXXXXXXXXXXX                   X          XXX XXXXXXXX
XXXXXXXX XXX XX XXXXXXXXXXXX XXXXX XXXXXX                  XXXXXX XXXXX XXXXXXXXXXXX XX XXX XXXXXXXX
XXXX         XX XXXXXXXXXXXX XXXXX XXXXXX XXXXXXXXXXXXXXXX XXXXXX XXXXX XXXXXXXXXXXX XX         XXXX
XXXX XXXXXXX                 XXXXX XXXXXX XXXXXXXXXXXXXXXX XXXXXX XXXXX                 XXXXXXX XXXX
XXXX XXXXXXX XXXXXXXXXXXXXXX                     XX                     XXXXXXXXXXXXXXX XXXXXXX XXXX
XXXX           XX            XXXXXXXXXXX XXXXXXXXXXXXXXXXXX XXXXXXXXXXX            XX           XXXX
XXXX XXXXXXXXXXXXXXX XXXXXXX XXXXXXXXXXX XXXXXXXXXXXXXXXXXX XXXXXXXXXXX XXXXXXX XXXXXXXXXXXXXXX XXXX
XXXX XXX           X XXXXXXX                     XX                     XXXXXXX X           XXX XXXX
XXXX XXX XXXXXXXXX      X    XXXXXXXXXXX XXXXXXXXXXXXXXXXXX XXXXXXXXXXX    X      XXXXXXXXX XXX XXXX
XXXX               XXXXXXXXX             XXXXXXXXXXXXXXXXXX             XXXXXXXXX               XXXX
XXXXXXXXXXXXXXXXXX XXXXXXXXX XXXXXXXXXXX XXXXXXXXXXXXXXXXXX XXXXXXXXXXX XXXXXXXXX XXXXXXXXXXXXXXXXXX
XXXXXXXXXXXXXXXXXX           XXXXXXXXXXX                    XXXXXXXXXXX           XXXXXXXXXXXXXXXXXX
XXXXXXXXXXXXXXXXXXXXXXXXXXXXXXXXXXXXXXXXXXXXXXXXXXXXXXXXXXXXXXXXXXXXXXXXXXXXXXXXXXXXXXXXXXXXXXXXXXXX
XXXXXXXXXXXXXXXXXXXXXXXXXXXXXXXXXXXXXXXXXXXXXXXXXXXXXXXXXXXXXXXXXXXXXXXXXXXXXXXXXXXXXXXXXXXXXXXXXXXX
