XXXXXXXXXXXXXXXXXXXXXXXXXXXXXXXXXXXXXXXXXXXXXXXXXXXXXXXXXXXXXXXXXXXXXXXXXXXXXXXXXXXXXXXXXXXXXXXXXXXX
XXXXXXXXXXXXXXXXXXXXXXXXXXXXXXXXXXXXXXXXXXXXXXXXXXXXXXXXXXXXXXXXXXXXXXXXXXXXXXXXXXXXXXXXXXXXXXXXXXXX
XXXX                  XXXXXXXXXXX             XXXXXXXXX               XXXXX                     XXXX
XXXX  XXXXXXXXXXXXXXX XXXXXXXXXXX XXXXXXXXXXX XXXXXXXXX XXXXX XXXXXXX XXXXX XXXXXXXXXXXXXXXXXXX XXXX
XXXX  XXXXXXXXXXXXXXX XXXXXXXXXXX XXXXXXXXXXX           XXXXX XXXXXXX XXXXX XXXXXXXXXXXXXXXXXXX XXXX
XXXX  XXXXX                  XXXX             XXXXXXXXX       XXXXXXX                   XXXXXXX XXXX
XXXX  XXXXX XXXXXXXXXXXXXXXX      XXXXXXXXXXX XXXXXXXXX XXXXX XXXXXXXXXXXXXXXX  XXXXXXX         XXXX
XXXX                         XXXXXXXXXXXXXXXX           XXXXX XXXXXXXXXXXXXXXX          XXXXXXX XXXX
XXXX  XXXXXXXXXXXX XXXXXXXXX XXXXXXXXXXXXXXXX XXXXXXXXX XXXXX XXXXXXXXXXXXXXXX  XXXXXXX XXXXXXX XXXX
XXXX  XXXXXXXXXXXX XXXXXXXXX                  XXXXXXXXX                         XXXXXXX         XXXX
XXXX               XXXXXXXXX XXXXXXXXXXXXXXXX XXXXXXXXX XXXXXXXXXXX XXXXXXXXXX          XXXXXXXXXXXX
XXXXXXXXX  XXXXXXX XXXXXXXXX XXXXXXXXXXXXXXXX XXXXXXXXX XXXXXXXXXXX XXXXXXXXXX  XXXXXXX XXXXXXXXXXXX
XXXXXX     XXXXXXX                                                              XXXXXXX XXXXXXXXXXXX
XXXXXX XXX XXXXXXX XXXXXXXXXXXXXXXXXXXX XXXXXXXXXXXXXXXXXX XXXXXX XXXXXXX XXXXXXXXXXXXX         XXXX
XXXXXX XXX         XXXXXXXXXXXXXXXXXXXX XXXXXXXXXXXXXXXXXX XXXXXX XXXXXXX XXXXXXXXXXXXX XXXXXXX XXXX
XXXXXX XXX XXXXXXX                                         XXXXXX XXXXXXX XXXXXXXXXXXXX         XXXX
XXXXXX     XXXXXXX XXXXXXXXXXXXX XXXXXX XXXX XXXXXXXXXXXXX XXXXXX                       XXXXXXX XXXX
XXXXXX XXX XXXXXXX XXXXXXXXXXXXX XXXXXX XXXX               XXXXXX XXXXX XXXXXXXXXXXX XX XXXXXXX XXXX
XXXXXX XXX XXXXXXX               XXXXXX XXXXXXXXXXXXX XXXXXXXXXXX XXXXX XXXXXXXXXXXX XX         XXXX
XXXXXX XXX         XXXXXXXXXXXXX XXXXXX XXXXXXXXXXXXX XXXXXXXXXXX XXXXX XXXXXXX      XX XXXXXXX XXXX
XXXXXX XXXXXXXXXXX XXXXXXXXXXXXX XXXXXX                                 XXXXXXX XXXXXXX XXXXXXX XXXX
XXXXXX                           XXXXXXX XXXXXXXXXXXXXXXXXX XXXXXXXXXXX                         XXXX
XXXXXX XXXXXXXXXXX XXXXXX XXXXXX XXXXXXX                    XXXXXXXXXXX XXXXXXX XXXXXXXXXXXXXXX XXXX
XXXX               XXXXXX XXXXXX XXXXXXX XXXXXXXXXXXXXXXXXX             XXXXXXX XXXXXXXXXXXXXXX XXXX
XXXX XXXXX XXXXXXXXXXXXXX XXXXXX XXXXXXX XXXXXXXXXXXXXXXXXX XXXXXXXXXXX XXXXXXX                 XXXX
XXXX XXXXX                       XXXXXXX                    XXXXXXXXXXX XXXXXXXXX XXXXXXXXXXXXX XXXX
XXXX XXXXX XXXXXXXXXXXXXXXXXXXXX XXXXXXX XXXXXXXXXXXXXXXXXX XXXXXXXXXXX XXXXXXXXX XXXXXXXXXXXXX XXXX
XXXX                                     XXXXXXXXXXXXXXXXXX                                     XXXX
XXXXXXXXXXXXXXXXXXXXXXXXXXXXXXXXXXXXXXXXXXXXXXXXXXXXXXXXXXXXXXXXXXXXXXXXXXXXXXXXXXXXXXXXXXXXXXXXXXXX
XXXXXXXXXXXXXXXXXXXXXXXXXXXXXXXXXXXXXXXXXXXXXXXXXXXXXXXXXXXXXXXXXXXXXXXXXXXXXXXXXXXXXXXXXXXXXXXXXXXX
