XXXXXXXXXXXXXXXXXXXXXXXXXXXXXXXXXXXXXXXXXXXXXX        XXXXXXXXXXXXXXXXXXXXXXXXXXXXXXXXXXXXXXXXXXXXXX
XXXXXXXXXXXXXXXXXXXXXXXXXXXXXXXXXXXXXXXXXXXXXXXXXXXXXXXXXXXXXXXXXXXXXXXXXXXXXXXXXXXXXXXXXXXXXXXXXXXX
XXXX          XX         XXXXX    X           XXXXXXXX           X    XXXXX         XX          XXXX
XXXX XXXXXXXXXXXXXXXXXXX XXXXX XXXXXXX XXXXXX XXXXXXXX XXXXXX XXXXXXX XXXXX XXXXXXXXXXXXXXXXXXX XXXX
XXXX                                                                                            XXXX
XXXX XXXXXXX XXXXXXX XXXXXXXXXXXXXXXXX XXXXXX XXXXXXXX XXXXXX XXXXXXXXXXXXXXXXX XXXXXXX XXXXXXX XXXX
XXXX XXXXXXX XXXXXXX XXXXXXXXXXXXXXXXX XXXXXX XXXXXXXX XXXXXX XXXXXXXXXXXXXXXXX XXXXXXX XXXXXXX XXXX
XXXX                                                                                            XXXX
XXXX XXXXXXX XXXXXXX XXXXXXXXXXXXXXXXX XXXXX XXXXXXXXXX XXXXX XXXXXXXXXXXXXXXXX XXXXXXX XXXXXXX XXXX
XXXX                                                                                            XXXX
XXXXXXXXXXXX XXXXXXX XXXXXXXXXXX XXXXXXXXXXX XXXXXXXXXX XXXXXXXXXXX XXXXXXXXXXX XXXXXXX XXXXXXXXXXXX
XXXXXXXXXXXX XXXXXXX XXXXXXXXXXX XXXXXXXXXXX XXXXXXXXXX XXXXXXXXXXX XXXXXXXXXXX XXXXXXX XXXXXXXXXXXX
XXXX                                                                                            XXXX
XXXXXXXXXXXX XXX XXXXXXXXX XXXXXXX XXXXXX XXXXXXXXXXXXXXXX XXXXXX XXXXXXX XXXXXXXXX XXX XXXXXXXXXXXX
XXXXXXXXXXXX XXX XXXXXXXXX XXXXXXX XXXXXX XXXXXXXXXXXXXXXX XXXXXX XXXXXXX XXXXXXXXX XXX XXXXXXXXXXXX
XXXX                                                                                            XXXX
XXXXXXXX XXX XX XXXXXXXXXXXX XXXXX XXXXXX XXXXXXXXXXXXXXXX XXXXXX XXXXX XXXXXXXXXXXX XX XXX XXXXXXXX
XXXXXXXX XXX XX XXXXXXXXXXXX XXXXX XXXXXX XXXXXXXXXXXXXXXX XXXXXX XXXXX XXXXXXXXXXXX XX XXX XXXXXXXX
XXXX                                                                                            XXXX
XXXX XXXXXXX XXXXXXXXXXXXXXX XXXXXXXXXXXX XXXXXXXXXXXXXXXX XXXXXXXXXXXX XXXXXXXXXXXXXXX XXXXXXX XXXX
XXXX                                                                                            XXXX
XXXX XXXXXXXXXXXXXXX XXXXXXX XXXXXXXXXXX XXXXXXXXXXXXXXXXXX XXXXXXXXXXX XXXXXXX XXXXXXXXXXXXXXX XXXX
XXXX XXXXXXXXXXXXXXX XXXXXXX XXXXXXXXXXX XXXXXXXXXXXXXXXXXX XXXXXXXXXXX XXXXXXX XXXXXXXXXXXXXXX XXXX
XXXX                                                                                            XXXX
XXXX XXX XXXXXXXXXXXXXXXXXXXXXXXXXXXXXXX XXXXXXXXXXXXXXXXXX XXXXXXXXXXXXXXXXXXXXXXXXXXXXXXX XXX XXXX
XXXX XXX XXXXXXXXXXXXXXXXXXXXXXXXXXXXXXX XXXXXXXXXXXXXXXXXX XXXXXXXXXXXXXXXXXXXXXXXXXXXXXXX XXX XXXX
XXXX               XXXXXXXXX             XXXXXXXXXXXXXXXXXX             XXXXXXXXX               XXXX
XXXXXXXXXXXXXXXXXX           XXXXXXXXXXX                    XXXXXXXXXXX           XXXXXXXXXXXXXXXXXX
XXXXXXXXXXXXXXXXXXXXXXXXXXXXXXXXXXXXXXXXXXXXXXXXXXXXXXXXXXXXXXXXXXXXXXXXXXXXXXXXXXXXXXXXXXXXXXXXXXXX
XXXXXXXXXXXXXXXXXXXXXXXXXXXXXXXXXXXXXXXXXXXXXXXXXXXXXXXXXXXXXXXXXXXXXXXXXXXXXXXXXXXXXXXXXXXXXXXXXXXX
