XXXXXXXXXXXXXXXXXXXXXXXXXXXXXXXXXXXXXXXXXXXXXXXXXXXXXXXXXXXXXXXXXXXXXXXXXXXXXXXXXXXXXXXXXXXXXXXXXXXX
XXXXXXXXXXXXXXXXXXXXXXXXXXXXXXXXXXXXXXXXXXXXXXXXXXXXXXXXXXXXXXXXXXXXXXXXXXXXXXXXXXXXXXXXXXXXXXXXXXXX
XXXX     X            XXXXXXXXXXX     X       XXXXXXXXX          X    XXXXX         XX          XXXX
XXXX XXXXXXXXXX XXXXXXXXXXXXXXXXX XXXXXXXXXXX XXXXXXXXX XXXXX XXXXXXX XXXXX XXXXXXXXXXXXXXXXXXX XXXX
XXXX XXXXXXXXXX XXXXXXXXXXXXXXXXX XXXXXXXXXXX     X     XXXXX XXXXXXX XXXXX XXXXXXXXXXXXXXXXXXX XXXX
XXXX XXXXXX          X       XXXX             XXXXXXXXX   X   XXXXXXX              X    XXXXXXX XXXX
XXXX XXXXXX XXXXXXXXXXXXXXXX      XXXXXXXXXXX XXXXXXXXX XXXXX XXXXXXXXXXXXXXXXX XXXXXXX XXXXXXX XXXX
XXXX                  X      XXXXXXXXXXXXXXXX           XXXXX XXXXXXXXXXXXXXXXX         XXXXXXX XXXX
XXXX XXXXXXXXXXXXX XXXXXXXXX XXXXXXXXXXXXXXXX XXXXXXXXX XXXXX XXXXXXXXXXXXXXXXX XXXXXXX XXXXXXX XXXX
XXXX XXXXXXXXXXXXX XXXXXXXXX                  XXXXXXXXX                         XXXXXXX         XXXX
XXXX               XXXXXXXXX XXXXXXXXXXXXXXXXXXXXXXXXXX XXXXXXXXXXX XXXXXXXXXXX XXXXXXX XXXXXXXXXXXX
XXXX XXXX  XXX XXXXXXXXXXXXX XXXXXXXXXXXXXXXXXXXXXXXXXX XXXXXXXXXXX XXXXXXXXXXX     XXX         XXXX
XXXX X     XXX XXX                             XX                    X          XXX XXXXXXXXXXX XXXX
XXXX X XXX XXX XXX XXXXXXXXXXXXXXXXXXXX XXXXXXXXXXXXXXXXXX XXXXXX XXXXXXX XXXXXXXXX XXX         XXXX
XXXX X XXX         XXXXXXXXXXXXXXXXXXXX XXXXXXXXXXXXXXXXXX XX XXX XXXXXXX XXXXXXXXX XXX XXXXXXXXXXXX
XXXX X XXX XXXXXXX                                         XX XXX XXXXXXX XXXXXXXXX XXX XXX XXXXXXXX
XXXX XXXXX XXXXXXX XXXXXXXXXXXXX XXXXXX XXXX XXXXXXXXXXXXX                   X          XXX XXXXXXXX
XXXX X XXX XXXXXXX XXXXXXXXXXXXX XXXXXX XXXX               XXXXXX XXXXX XXXXXXXXXXXX XX XXX XXXXXXXX
XXXX X XXX XXXXXXX       X       XXXXXX XXXXXXXXXXXXX XXXXXXXXXXX XXXXX XXXXXXXXXXXX XX         XXXX
XXXX X XXX         XXXXXXXXXXXXXXXXXXXX XXXXXXXXXXXXX XXXXXXXXXXX XXXXX XXXXXXXXXXXXXXX XXXXXXX XXXX
XXXX X XXXXXXXXXXX XXXXXXXXXXXXXXXXXXXX          X                      XXXXXXXXXXXXXXX XXXXXXX XXXX
XXXX X                           XXXXXXX XXXXXXXXXXXXXXXXXX XXXXXXXXXXX            XX           XXXX
XXXX X XXXXXXXXXXX XXXXXXXXXXXXX XXXXXXX XXXXXXXXXXXXXXXXXX XXXXXXXXXXX XXXXXXX XXXXXXXXXXXXXXX XXXX
XXXX        X      XXXXXXXXXXXXX XXXXXXX         X               X      XXXXXXX XXXXXXXXX   XXX XXXX
XXXXXXXXXXXXX XXXXXXXXXXXXXXXXXX XXXXXXX XXXXXXXXXXXXXXXXXX XXXXXXXXXXX    X      XXXXXXXXX XXX XXXX
XXXX XXXXX          XX           XXXXXXX XXXXXXXXXXXXXXXXXX             XXXXXXXXX               XXXX
XXXX XXXXX XXXXXXXXXXXXXXXXXXXXX XXXXXXX XXXXXXXXXXXXXXXXXX XXXXXXXXXXX XXXXXXXXX XXXXXXXXXXXXXXXXXX
XXXX                XX           XXXXXXX                    XXXXXXXXXXX           XXXXXXXXXXXXXXXXXX
XXXXXXXXXXXXXXXXXXXXXXXXXXXXXXXXXXXXXXXXXXXXXXXXXXXXXXXXXXXXXXXXXXXXXXXXXXXXXXXXXXXXXXXXXXXXXXXXXXXX
XXXXXXXXXXXXXXXXXXXXXXXXXXXXXXXXXXXXXXXXXXXXXXXXXXXXXXXXXXXXXXXXXXXXXXXXXXXXXXXXXXXXXXXXXXXXXXXXXXXX
