XXXXXXXXXXXXXXXXXXXXXXXXXXXXXXXXXXXXXXXXXXXXXXXXXXXXXXXXXXXXXXXXXXXXXXXXXXXXXXXXXXXXXXXXXXXXXXXXXXXX
X        X                   X                   X                    X                            X
X        X                   X                   X                    X                            X
X        X                   X                   X                    X                            X
XXXXXXXXXXXXXXXXXXXXX        X        X          X          X         X        XXXXXXXXXXXX        X
X        X                            X          X          X                             X        X
X        X         X                  X          X          X                             X        X
X        X         X                  X          X          X                             X        X
X                  X         X        X          X          X                   X                  X
X        XXXXXXXXX X         X        X                     X                   X                  X
X                  X         XXXXXXXXXXXXX               XXXXXXXXXXXXX          X                  X
XXXXXXXXXX         X                                                            X          XXXXXXXXX
XXXXXXXXXX         X                                                            X                  X
XXXXXXXXXX         X                                                            X                  X
XXXXXXXXXX         XXXXXXX              XXXXXXXXXXXXXXXXXXXX              XXXXXXX                  X
X                                       X                  X                                       X
X XXXXXXXX                              X                  X                              X        X
X XXXXXXXX                              X                  X                              X        X
X XXXXXXXX       XXXXXXXX               XXXXXX        XXXXXX               XXXXXX         X        X
X XXXXXXXX              X        X                                X        X              X        X
X XXXXXXXXXXXXXX        X        X                                X        X              X        X
X XXXXXXXXXXXXXX        X        X               X                X        X              X        X
X XXXXXXXXXXXXXX        X        XXXXXXX         X          XXXXXXX        X        XXXXXXX        X
X                       X        X               X                X        X                       X
X                       X        X                                X        X                       X
X        X              X        X                                X        X              X        X
X        X         XXXXXX        X      XXXXXXXXXXXXXXXXXXXX      X        XXXXXX         X        X
X                                                                                                  X
X                                                                                                  X
XXXXXXXXXXXXXXXXXXXXXXXXXXXXXXXXXXXXXXXXXXXXXXXXXXXXXXXXXXXXXXXXXXXXXXXXXXXXXXXXXXXXXXXXXXXXXXXXXXXX
