XXXXXXXXXXXXXXXXXXXXXXXXXXXXXXXXXXXXXXXXXXXXXXXXXXXXXXXXXXXXXXXXXXXXXXXXXXXXXXXXXXXXXXXXXXXXXXXXXXXX
XXXXXXXXXXXXXXXXXXXXXXXXXXXXXXXXXXXXXXXXXXXXXXXXXXXXXXXXXXXXXXXXXXXXXXXXXXXXXXXXXXXXXXXXXXXXXXXXXXXX
XXXX                  XXXXXXXXXXX             XXXXXXXXX               XXXXX                     XXXX
XXXX  XXXXXXXXXXXXXXX XXXXXXXXXXX XXXXXXXXXXX XXXXXXXXX XXXXX XXXXXXX XXXXX XXXXXXXXXXXXXXXXXXX XXXX
XXXX  XXXXXXXXXXXXXXX XXXXXXXXXXX XXXXXXXXXXX XXXXXXXXX XXXXX XXXXXXX XXXXX XXXXXXXXXXXXXXXXXXX XXXX
XXXX  XXXXX                  XXXX XXXXXXXXXXX XXXXXXXXX XXXXX XXXXXXX                   XXXXXXX XXXX
XXXX  XXXXX XXXXXXXXXXXXXXXX      XXXXXXXXXXX XXXXXXXXX XXXXX XXXXXXXXXXXXXXXX  XXXXXXX XXXXXXX XXXX
XXXX                         XXXXXXXXXXXXXXXX XXXXXXXXX XXXXX XXXXXXXXXXXXXXXX  XXXXXXX XXXXXXX XXXX
XXXX  XXXXXXXXXXXX XXXXXXXXX XXXXXXXXXXXXXXXX XXXXXXXXX XXXXX XXXXXXXXXXXXXXXX  XXXXXXX XXXXXXX XXXX
XXXX  XXXXXXXXXXXX XXXXXXXXX XXXXXXXXXXXXXXXX XXXXXXXXX XXXXX                   XXXXXXX         XXXX
XXXX       XXXXXXX XXXXXXXXX XXXXXXXXXXXXXXXX XXXXXXXXX XXXXXXXXXXXXXXXXXXXXXX  XXXXXXX XXXXXXXXXXXX
XXXXXXXXX  XXXXXXX XXXXXXXXX XXXXXXXXXXXXXXXX XXXXXXXXX XXXXXXXXXXXXXXXXXXXXXX  XXXXXXX XXXXXXXXXXXX
XXXXXX     XXXXXXX                                                              XXXXXXX XXXXXXXXXXXX
XXXXXX XXX XXXXXXX XXXXXXXXXXXXXXXXXXXX XXXXXXXXXXXXXXXXXX XXXXXX XXXXXXX XXXXXXXXXXXXX         XXXX
XXXXXX XXX XXXXXXX XXXXXXXXXXXXXXXXXXXX XXXXXXXXXXXXXXXXXX XXXXXX XXXXXXX XXXXXXXXXXXXX XXXXXXX XXXX
XXXXXX XXX XXXXXXX                                         XXXXXX XXXXXXX XXXXXXXXXXXXX XXXXXXX XXXX
XXXXXX XXX XXXXXXX XXXXXXXXXXXXX XXXXXX XXXX XXXXXXXXXXXXX XXXXXX                       XXXXXXX XXXX
XXXXXX XXX XXXXXXX XXXXXXXXXXXXX XXXXXX XXXX               XXXXXX XXXXX XXXXXXXXXXXX XX XXXXXXX XXXX
XXXXXX XXX XXXXXXX XXXXXXXXXXXXX XXXXXX XXXXXXXXXXXXX XXXXXXXXXXX XXXXX XXXXXXXXXXXX XX XXXXXXX XXXX
XXXXXX XXX         XXXXXXXXXXXXX XXXXXX XXXXXXXXXXXXX XXXXXXXXXXX XXXXX XXXXXXX      XX XXXXXXX XXXX
XXXXXX XXXXXXXXXXX XXXXXXXXXXXXX XXXXXX                     XXXXXXXXXXX XXXXXXX XXXXXXX XXXXXXX XXXX
XXXXXX XXXXXXXXXXX XXXXXXXXXXXXX XXXXXXX XXXXXXXXXXXXXXXXXX XXXXXXXXXXX XXXXXXX         XXXXXXX XXXX
XXXXXX XXXXXXXXXXX XXXXXXXXXXXXX XXXXXXX XXXXXXXXXXXXXXXXXX XXXXXXXXXXX XXXXXXX XXXXXXXXXXXXXXX XXXX
XXXX               XXXXXXXXXXXXX XXXXXXX XXXXXXXXXXXXXXXXXX             XXXXXXX XXXXXXXXXXXXXXX XXXX
XXXX XXXXX XXXXXXXXXXXXXXXXXXXXX XXXXXXX XXXXXXXXXXXXXXXXXX XXXXXXXXXXX XXXXXXX                 XXXX
XXXX XXXXX XXXXXXXXXXXXXXXXXXXXX XXXXXXX                    XXXXXXXXXXX XXXXXXXXX XXXXXXXXXXXXX XXXX
XXXX XXXXX XXXXXXXXXXXXXXXXXXXXX XXXXXXX XXXXXXXXXXXXXXXXXX XXXXXXXXXXX XXXXXXXXX XXXXXXXXXXXXX XXXX
XXXX                                     XXXXXXXXXXXXXXXXXX                                     XXXX
XXXXXXXXXXXXXXXXXXXXXXXXXXXXXXXXXXXXXXXXXXXXXXXXXXXXXXXXXXXXXXXXXXXXXXXXXXXXXXXXXXXXXXXXXXXXXXXXXXXX
XXXXXXXXXXXXXXXXXXXXXXXXXXXXXXXXXXXXXXXXXXXXXXXXXXXXXXXXXXXXXXXXXXXXXXXXXXXXXXXXXXXXXXXXXXXXXXXXXXXX
